  =====================
  =*********P********O=
  =*=====*=*=*=*=====*=
===*******=*=*=***O***===
  **=====*=*O*=*=====**
===***O***=*=*=*******===
  =*=====*=*=*=*=====*=
  =O********4*********=
  ==========X==========
          =123=
          =====